30 30
100 200
4 10 10 10 10 10 10 10 10 10 10 10 10 10 10 10 10 10 10 10 10 10 10 10 10 10 10 10 10 5
8 1  1  2  2  1  1  12 1  1  1  1  1  1  1  1  1  1  1  1  1  1  1  1  1  1  1  1  1  9
8 1  1  2  2  1  1  12 1  1  1  1  1  1  1  1  1  1  1  1  1  1  1  1  1  1  1  1  1  9
8 1  1  2  2  1  1  12 1  1  1  1  1  1  1  1  2  2  2  2  2  2  2  2  2  2  2  2  1  9
8 1  1  2  2  1  1  12 1  1  1  1  1  1  1  1  2  2  2  2  2  2  2  2  2  2  2  2  1  9
8 1  1  2  2  1  1  12 1  1  1  1  1  1  1  1  2  2  1  1  1  1  1  1  1  1  1  2  1  9
8 1  1  2  2  1  1  12 1  1  1  1  1  1  1  1  2  2  1  1  1  1  1  1  1  1  1  2  1  9
8 1  1  2  2  1  1  12 1  1  1  1  1  12 1  1  2  2  1  1  12 1  1  1  1  12 1  2  1  9
8 1  1  2  2  1  1  12 1  1  1  1  1  12 1  1  2  2  1  1  12 1  1  1  1  12 1  2  1  9
8 1  1  2  2  1  1  12 1  1  1  1  1  12 1  1  2  2  1  1  12 1  1  1  1  12 1  2  1  9
8 1  1  2  2  1  1  12 1  1  1  1  1  12 1  1  2  2  1  1  12 1  1  1  1  12 1  2  1  9
8 1  1  2  2  1  1  12 1  1  1  1  1  12 1  1  2  2  1  1  12 1  1  1  1  12 1  2  1  9
8 1  1  2  2  1  1  12 1  1  1  1  1  12 1  1  2  2  1  1  12 1  1  1  1  12 1  2  1  9
8 1  1  2  2  1  1  12 1  1  1  1  1  12 1  1  2  2  1  1  12 1  1  1  1  12 1  2  1  9
8 1  1  2  2  1  1  12 12 12 12 12 12 12 1  1  2  2  1  1  12 1  1  1  1  12 1  2  1  9
8 1  1  2  2  1  1  12 1  1  1  1  1  1  1  1  2  2  1  1  12 1  1  1  1  12 1  2  1  9
8 1  1  2  2  1  1  12 1  1  1  1  1  1  1  1  2  2  1  1  12 1  1  1  1  12 1  2  1  9
8 1  1  2  2  1  1  12 1  1  1  1  1  1  1  1  2  2  1  1  12 1  1  1  1  12 1  2  1  9
8 1  1  2  2  1  1  12 1  1  2  2  2  2  2  2  2  2  1  1  12 1  1  1  1  12 1  2  1  9
8 1  1  2  2  1  1  12 1  1  2  1  1  1  1  1  1  1  1  1  12 1  1  1  1  12 1  2  1  9
8 1  1  2  2  1  1  12 1  1  2  1  1  1  1  1  1  1  1  1  12 12 12 12 12 12 1  2  1  9
8 1  1  2  2  1  1  12 1  1  2  1  1  1  1  1  1  1  1  1  12 1  1  1  1  1  1  1  1  9
8 1  1  2  2  1  1  12 1  1  2  1  1  12 1  1  1  1  1  1  12 1  1  1  1  1  1  1  1  9
8 1  1  2  2  1  1  1  1  1  2  1  1  12 1  1  1  1  1  1  12 1  1  1  1  1  1  1  1  9
8 1  1  2  2  1  1  1  1  1  2  1  1  12 1  1  1  1  1  1  12 1  1  1  1  1  1  1  1  9
8 1  1  2  2  2  2  2  2  2  2  1  1  12 1  1  1  1  1  1  12 1  1  1  1  1  1  1  1  9
8 1  1  2  2  2  2  2  2  2  2  1  1  12 1  1  1  1  1  1  12 1  1  1  1  1  1  1  1  9
8 1  1  1  1  1  1  1  1  1  1  1  1  12 1  1  1  1  1  1  12 1  1  1  1  1  1  1  1  9
8 1  1  1  1  1  1  1  1  1  1  1  1  12 1  1  1  1  1  1  12 1  1  1  1  1  1  1  1  9
7 11 11 11 11 11 11 11 11 11 11 11 11 11 11 11 11 11 11 11 11 11 11 11 11 11 11 11 11 6

